1,1,1,1,1,1,1,1,1,1
1,0,1,0,0,0,0,0,0,1
1,0,1,0,0,6,0,0,0,1
1,0,2,4,0,2,0,0,0,1
1,0,0,0,0,0,1,0,4,1
1,0,0,0,1,3,1,1,1,1
1,1,0,0,1,1,1,0,3,1
1,0,0,0,1,0,2,0,0,1
1,0,3,0,0,0,0,0,0,1
1,1,1,1,1,1,1,1,1,1