1,1,1,1,1,1,1,1,1
1,3,2,0,1,0,2,3,1
1,2,3,1,1,1,3,2,1
1,0,1,3,1,3,1,0,1
1,1,1,1,7,1,1,1,1
1,0,1,3,1,3,1,0,1
1,2,3,1,1,1,3,2,1
1,3,2,0,1,0,2,3,1
1,1,1,1,1,1,1,1,1